...###
..##.#.####
.##..###..#
##........#
#..#@#.#..#
##...###..#
..#..#....#
.##.##.#.##
.#......##
.#........
.#######